# LABIRINTO
largura=25
altura=20
# cada celula: 4 digitos NESW (1 = tem parede, 0 = passagem)
celulas=
1101 1011 1010 1100 1001 1100 1001 1010 1010 1010 1010 1010 1010 1010 1000 1100 1011 1000 1100 1001 1010 1010 1010 1010 1100
0101 1001 1100 0011 0100 0011 0010 1010 1110 1001 1010 1100 1001 1100 0101 0011 1010 0110 0101 0011 1010 1010 1000 1100 0101
0011 0110 0011 1100 0101 1001 1010 1010 1100 0101 1101 0101 0101 0011 0110 1001 1010 1100 0011 1010 1010 1100 0111 0101 0101
1001 1010 1100 0101 0111 0101 1011 1100 0011 0110 0001 0110 0101 1101 1001 0010 1100 0011 1100 1001 1110 0011 1100 0101 0101
0101 1001 0100 0011 1010 0110 1001 0110 1001 1100 0101 1001 0110 0001 0110 1001 0110 1101 0101 0101 1001 1010 0110 0101 0101
0101 0101 0011 1100 1011 1000 0100 1001 0110 0101 0101 0101 1101 0011 1100 0011 1100 0011 0010 0100 0101 1011 1000 0110 0101
0101 0101 1011 0010 1010 0110 0111 0101 1001 0110 0011 0110 0001 1010 0110 1101 0101 1001 1100 0111 0011 1010 0110 1101 0101
0101 0011 1010 1100 1001 1010 1010 0110 0011 1010 1010 1010 0110 1001 1000 0110 0101 0101 0011 1010 1010 1010 1010 0010 0110
0011 1100 1101 0011 0110 1101 1001 1010 1010 1100 1001 1010 1010 0110 0011 1100 0011 0110 1001 1010 1100 1001 1000 1010 1100
1101 0011 0100 1001 1010 0010 0010 1100 1001 0100 0011 1100 1001 1100 1101 0011 1000 1110 0011 1100 0011 0110 0101 1001 0110
0001 1010 0110 0111 1001 1100 1001 0110 0101 0011 1110 0011 0110 0101 0011 1100 0011 1000 1100 0101 1001 1110 0101 0101 1101
0101 1001 1100 1001 0110 0101 0111 1001 0110 1001 1010 1000 1110 0011 1100 0101 1001 0110 0111 0101 0101 1001 0110 0101 0101
0101 0101 0011 0110 1101 0011 1100 0011 1010 0010 1110 0011 1010 1010 0010 0100 0101 1001 1100 0011 0100 0101 1011 0010 0100
0101 0001 1010 1100 0001 1010 0110 1001 1010 1010 1010 1010 1010 1010 1100 0101 0101 0101 0101 1001 0110 0011 1100 1001 0110
0101 0111 1001 0110 0101 1001 1010 0110 1101 1001 1100 1001 1010 1100 0101 0111 0011 0110 0011 0010 1010 1100 0101 0011 1100
0011 1100 0101 1101 0101 0101 1001 1110 0001 0110 0011 0010 1110 0101 0011 1100 1001 1010 1010 1100 1101 0101 0011 1100 0101
1101 0011 0110 0101 0011 0110 0011 1010 0010 1110 1001 1010 1010 0010 1110 0011 0110 1001 1010 0110 0011 0010 1110 0101 0101
0001 1010 1100 0001 1000 1010 1010 1010 1010 1100 0101 1001 1010 1010 1010 1000 1110 0101 1011 1010 1000 1010 1100 0101 0101
0011 1100 0101 0101 0101 1001 1100 1011 1010 0010 0110 0101 1011 1010 1100 0101 1001 0110 1001 1100 0101 1101 0011 0110 0101
1011 0110 0011 0110 0011 0110 0011 1010 1010 1010 1010 0010 1010 1010 0110 0011 0010 1010 0110 0011 0110 0011 1010 1010 0110

# ESTATISTICAS
algoritmo=BFS
custo=253
nos_expandidos=406
max_nos_memoria=6
iteracoes=406

# ESTATISTICAS
algoritmo=DFS
custo=253
nos_expandidos=472
max_nos_memoria=21
iteracoes=472

# ESTATISTICAS
algoritmo=ASTAR
custo=253
nos_expandidos=355
max_nos_memoria=6
iteracoes=355

# ESTATISTICAS
algoritmo=DIJKSTRA
custo=253
nos_expandidos=409
max_nos_memoria=6
iteracoes=409

# ESTATISTICAS
algoritmo=GREEDY
custo=253
nos_expandidos=317
max_nos_memoria=8
iteracoes=317

